40 41
595 1200
9 9 9 9 9 9 9 9 9 9 9 9 9 9 9 9 9 9 9 9 9 9 9 9 9 9 9 9 9 9 9 9 9 9 9 9 9 9 9 9
9 10 10 10 10 18 0 0 0 0 0 0 23 0 0 0 16 10 10 10 10 18 23 0 0 0 23 0 0 0 23 0 0 0 16 10 10 10 10 9
9 10 10 10 10 18 0 0 23 0 0 0 0 23 0 0 16 10 10 10 10 18 0 0 23 0 0 0 0 0 0 23 0 0 16 10 10 10 10 9
9 10 10 10 10 18 23 0 0 0 0 23 0 0 0 0 16 10 10 10 10 18 0 0 0 0 0 0 23 0 23 0 0 23 16 10 10 10 10 9
9 10 10 10 10 13 15 15 15 15 15 15 15 15 15 15 14 10 10 10 10 13 15 15 15 15 15 15 15 15 15 15 15 15 14 10 10 10 10 9
9 10 10 10 10 10 10 10 10 10 10 10 10 10 10 10 10 10 10 10 10 10 10 10 10 10 10 10 10 10 10 10 10 10 10 10 10 10 10 9
9 10 10 10 12 17 17 17 17 17 17 11 10 12 17 17 17 17 17 17 17 17 17 17 11 10 12 17 17 17 17 17 17 17 17 11 10 10 10 9
9 10 10 10 18 23 0 0 0 23 0 16 10 18 24 24 24 0 0 0 0 24 24 24 16 10 18 0 23 0 23 0 0 23 0 16 10 10 10 9
9 10 10 10 18 0 23 0 0 0 0 16 10 18 24 23 0 0 23 0 23 0 0 24 16 10 18 23 0 0 0 0 23 0 0 16 10 10 10 9
9 10 10 10 18 23 0 23 0 0 0 16 10 18 24 0 23 0 0 0 0 0 23 24 16 10 18 0 0 23 0 0 0 0 23 16 10 10 10 9
9 10 10 10 18 0 0 0 0 23 0 16 10 18 24 0 0 0 23 0 0 0 0 24 16 10 18 0 0 23 0 0 23 0 0 16 10 10 10 9
9 10 10 10 18 23 0 0 0 0 0 16 10 18 24 0 23 0 0 0 23 0 0 24 16 10 18 23 0 0 23 0 0 0 23 16 10 10 10 9
9 10 10 10 18 0 23 0 0 23 0 16 10 18 24 24 24 0 0 0 0 24 24 24 16 10 18 0 23 0 0 0 23 0 0 16 10 10 10 9
9 10 10 10 13 15 15 15 15 15 15 14 10 13 15 15 15 15 15 15 15 15 15 15 14 10 13 15 15 15 15 15 15 15 15 14 10 10 10 9
9 10 10 10 10 10 10 10 10 10 10 10 10 10 10 10 10 10 10 10 10 10 10 10 10 10 10 10 10 10 10 10 10 10 10 10 10 10 10 9
9 17 17 17 17 17 17 17 17 17 17 17 17 17 17 17 17 11 10 10 12 17 17 17 17 17 17 17 17 17 17 17 17 17 17 17 17 17 17 9
9 0 0 0 0 0 0 0 0 0 0 0 0 23 0 0 0 16 10 10 18 0 0 23 0 0 0 0 0 0 0 23 0 0 0 0 0 0 0 9
9 0 23 0 0 23 0 0 0 10 10 10 10 10 0 23 0 16 10 10 18 0 0 23 0 0 0 0 0 23 0 0 0 0 0 0 0 0 0 9
9 0 0 0 0 0 0 0 0 10 9 9 9 9 10 0 0 16 10 10 18 0 23 0 0 0 0 0 0 23 0 0 0 0 0 0 0 0 0 9
9 0 23 0 19 15 15 15 15 10 10 10 10 10 10 15 15 14 10 10 18 0 0 0 0 0 0 0 0 0 23 0 0 0 0 0 0 0 0 9
9 0 0 0 16 10 10 10 10 10 10 10 10 10 10 10 10 10 10 10 18 0 0 23 0 0 0 0 0 10 10 10 10 10 10 10 0 0 0 9
9 0 0 0 16 10 12 17 17 10 10 10 10 10 10 17 17 11 10 10 18 0 0 0 0 0 0 0 0 10 9 9 9 9 9 10 0 0 0 9
9 0 0 0 16 10 18 0 0 10 9 9 9 9 10 0 23 16 10 10 13 15 15 15 15 15 15 15 15 10 10 10 10 10 9 10 0 0 0 9
9 0 0 0 16 10 18 0 0 10 10 10 10 10 10 0 0 16  10 10 10 10 10 10 10 10 10 10 10 10 10 10 10 10 9 10 0 0 0 9
9 0 0 0 16 10 18 0 0 0 0 0 0 0 23 0 0 16 10 10 12 17 17 17 17 17 17 17 17 10 10 10 10 10 9 10 0 0 0 9
9 0 0 0 16 10 18 0 0 0 23 0 0 0 0 0 0 16 10 10 18 0 23 0 0 0 0 0 0 10 9 9 9 9 9 10 0 0 0 9
9 0 0 0 16 10 18 0 0 0 0 0 0 0 0 0 0 16 10 10 18 0 0 0 0 0 0 0 0 10 10 10 10 10 10 10 0 0 0 9
9 0 10 9 10 10 10 10 23 0 0 23 0 0 0 23 0 16 10 10 18 0 0 0 23 0 0 0 0 0 0 0 23 0 0 0 23 0 0 9
9 0 10 9 10 10 10 10 15 15 15 15 15 15 15 15 15 14 10 10 18 0 0 0 0 0 0 23 0 0 0 0 0 23 0 0 0 0 23 9
9 0 10 9 10 10 10 10 10 10 10 10 10 10 10 10 10 10 10 10 18 0 0 23 0 10 10 10 10 10 10 10 0 0 0 0 0 0 0 9
9 0 10 9 10 10 10 10 17 17 17 17 17 17 17 17 17 11 10 10 18 0 0 0 0 10 9 9 9 9 9 10 0 23 0 0 0 0 0 9
9 0 10 9 9 9 9 9 0 0 0 0 0 0 0 23 0 16 10 10 13 15 15 15 15 10 10 10 10 10 9 10 0 0 0 0 0 0 23 9
9 23 10 10 10 10 10 0 0 0 23 0 0 0 0 23 0 16 10 10 10 10 10 10 10 10 10 10 10 10 9 10 0 0 23 0 0 0 0 9
9 0 0 0 23 0 0 0 0 23 0 0 0 0 0 23 0 16 10 10 12 17 17 17 17 10 10 10 10 10 9 10 0 0 0 0 0 0 0 9
9 15 15 15 15 15 15 20 0 0 23 0 0 0 0 0 0 16 10 10 18 0 0 0 0 10 9 9 9 9 9 10 0 19 15 15 15 15 15 9
9 10 10 10 10 10 10 18 23 0 0 0 0 0 0 0 23 16 10 10 18 0 23 0 0 10 10 10 10 10 10 10 0 16 10 10 10 10 10 9
9 10 10 10 10 10 10 18 0 0 0 0 23 0 0 0 0 16 10 10 18 0 0 0 0 0 0 23 0 0 0 0 0 16 10 10 10 10 10 9
9 10 10 10 10 10 10 18 0 23 0 0 0 0 23 0 0 16 10 10 18 0 0 0 0 0 0 0 0 0 0 0 0 16 10 10 10 10 10 9
9 10 10 10 10 10 10 13 15 15 15 15 15 15 15 15 15 14 10 10 13 15 15 15 15 15 15 15 15 15 15 15 15 14 10 10 10 10 10 9
9 10 10 10 10 10 10 10 10 10 10 10 10 10 10 10 10 10 10 10 10 10 10 10 10 10 10 10 10 10 10 10 10 10 10 10 10 10 10 9
9 9 9 9 9 9 9 9 9 9 9 9 9 9 9 9 9 9 9 9 9 9 9 9 9 9 9 9 9 9 9 9 9 9 9 9 9 9 9 9
