40 30
595 850
9 9 9 9 9 9 9 9 9 9 9 9 9 9 9 9 9 9 9 9 9 9 9 9 9 9 9 9 9 9 9 9 9 9 9 9 9 9 9 9
9 0 0 0 0 0 0 0 0 0 0 0 0 0 0 0 16 10 10 10 10 18 0 0 0 0 0 0 0 0 0 0 0 0 0 0 0 0 0 9
9 0 0 0 0 0 0 0 0 0 0 0 0 0 0 0 16 10 10 10 10 18 0 0 23 0 0 0 0 0 0 0 23 0 0 0 0 0 0 9
9 0 0 0 0 0 0 0 23 0 0 0 0 0 0 0 16 10 10 10 10 18 0 0 0 0 23 0 0 0 0 0 0 0 0 0 0 0 0 9
9 0 23 0 0 0 0 0 0 0 0 19 15 15 15 15 14 10 10 10 10 13 15 15 15 15 20 0 0 0 0 0 0 0 23 0 0 0 0 9
9 0 0 0 0 0 0 0 0 0 0 16 10 10 10 10 10 10 10 10 10 10 10 10 10 10 18 0 0 0 23 0 0 0 0 0 0 0 0 9
9 0 0 0 0 0 0 0 0 0 0 16 10 12 17 17 17 17 17 17 17 17 17 17 11 10 18 0 0 0 0 0 0 0 0 0 0 0 0 9
9 0 0 0 0 23 0 0 0 0 0 16 10 18 0 0 0 0 0 0 0 0 0 0 16 10 18 0 0 0 0 0 0 0 0 0 0 23 0 9
9 0 0 0 0 0 0 0 0 0 0 16 10 18 0 0 0 0 0 0 0 0 0 0 16 10 18 0 0 0 0 0 23 0 0 0 0 0 0 9
9 0 23 0 0 0 0 23 0 0 0 16 10 18 0 0 0 0 0 0 0 0 0 0 16 10 18 0 23 0 0 0 0 0 0 0 0 0 0 9
9 0 0 0 0 0 0 0 0 0 0 16 10 18 0 0 0 0 0 0 0 0 0 0 16 10 18 0 0 0 0 0 0 0 0 0 0 0 0 9
9 0 19 15 15 15 15 15 20 0 0 16 10 18 0 0 0 0 0 0 0 0 0 0 16 10 18 0 0 0 19 15 15 15 15 15 20 0 0 9
9 0 16 10 10 10 10 10 18 0 0 16 10 18 0 0 0 0 0 0 0 0 0 0 16 10 18 0 0 0 16 10 10 10 10 10 18 0 0 9
9 0 16 10 0 0 0 10 13 15 15 14 10 13 15 15 15 15 15 15 15 15 15 15 14 10 13 15 15 15 14 10 0 0 0 10 18 0 0 9
9 0 16 10 0 0 0 10 10 10 10 10 10 10 10 10 10 10 10 10 10 10 10 10 10 10 10 10 10 10 10 10 0 0 0 10 18 0 0 9
9 0 16 10 0 0 0 10 12 17 17 17 17 17 17 17 17 17 11 10 12 17 17 17 17 17 17 17 17 17 11 10 0 0 0 10 18 0 0 9
9 0 16 10 10 10 10 10 18 0 0 0 0 23 0 0 0 0 16 10 18 0 0 0 0 0 0 0 0 0 16 10 10 10 10 10 18 0 0 9
9 0 21 17 17 17 17 17 22 0 0 0 0 0 0 0 0 0 16 10 18 0 23 0 0 0 0 0 0 0 21 17 17 17 17 17 22 0 0 9
9 0 0 0 0 0 0 0 0 0 0 0 0 0 0 0 0 0 16 10 18 0 0 0 0 0 0 0 23 0 0 0 0 0 0 0 0 0 0 9
9 0 0 0 0 0 0 0 0 0 0 0 0 0 0 0 0 0 16 10 18 0 0 0 0 0 0 0 0 0 0 0 0 0 23 0 0 0 0 9
9 0 0 0 0 0 0 0 23 0 0 0 0 23 0 0 0 0 16 10 18 0 0 0 0 23 0 0 0 0 0 0 0 0 0 0 0 0 0 9
9 0 0 0 0 0 0 0 0 0 0 0 0 0 0 0 0 0 16 10 18 0 0 0 0 0 0 0 0 0 0 0 0 0 0 0 0 0 0 9
9 0 0 0 23 0 0 0 0 0 0 0 0 0 0 0 0 0 16 10 18 0 0 0 0 0 0 0 0 23 0 0 0 0 0 23 0 0 0 9
9 0 0 0 0 0 0 0 0 0 23 0 0 0 0 0 0 0 16 10 18 0 0 0 23 0 0 0 0 0 0 0 0 0 0 0 0 0 0 9
9 0 0 0 0 0 0 0 0 0 0 0 0 0 0 0 23 0 16 10 18 0 0 0 0 0 0 0 0 0 0 0 0 0 0 0 0 0 0 9
9 0 0 0 0 0 0 0 0 0 0 0 0 0 0 0 0 0 16 10 18 0 0 0 0 0 0 0 23 0 0 0 0 0 0 0 0 0 0 9
9 0 0 0 0 0 0 0 23 0 0 0 0 0 0 0 0 0 16 10 18 0 23 0 0 0 0 0 0 0 0 0 0 0 0 0 0 0 0 9
9 0 23 0 0 0 0 0 0 0 0 0 0 0 23 0 0 0 16 10 18 0 0 0 0 0 0 0 0 0 0 0 0 23 0 0 0 0 0 9
9 0 0 0 0 0 0 0 0 0 0 0 0 0 0 0 0 0 16 10 18 0 0 0 0 0 0 0 0 0 0 0 0 0 0 0 0 0 0 9
9 9 9 9 9 9 9 9 9 9 9 9 9 9 9 9 9 9 9 9 9 9 9 9 9 9 9 9 9 9 9 9 9 9 9 9 9 9 9 9
